GP GP GP GP GP GP GP GP GP GP GP GP GP GP GP GP GP
GP GP GP GP GP GP GP GP GP GP GP GP GP GP GP GP GP
GP GP GP GP GP GP GP GP GP GP GP GP GP GP GP GP GP
GP GP GP GP GP GP GP GP GP GP GP GP GP GP GP GP GP
GP GP GP GP GP GP GP GP GP GP GP GP GP GP GP GP GP
GP GP GP GP GP GP GP GP GP GP GP GP GP GP GP GP GP
DP DP DP DP GP GP GP GP GP GP GP GP GP GP GP GP GP
GP GP GP GP GP GP GP GP GP GP GP GP GP GP GP GP GP
GP GP GP GP GP GP GP GP GP GP GP GP GP GP GP GP GP
GP GP GP GP GP GP GP GP GP GP GP GP GP GP GP GP GP
GP GP GP GP GP GP GP GP GP GP GP GP GP GP GP GP GP
GP GP GP GP GP GP GP GP GP GP GP GP GP GP GP GP GP
GP GP GP GP GP GP GP GP GP GP GP GP GP GP GP GP DP
GP GP GP GP GP GP GP GP GP GP GP GP GP GP GP GP GP
GP GP GP GP GP GP GP GP GP GP GP GP GP GP GP GP GP
GP GP GP GP GP GP GP GP GP GP GP GP GP GP GP GP GP
GP GP GP GP GP GP GP GP GP GP GP GP GP GP GP GP GP
GP GP GP GP GP GP GP GP GP GP GP GP GP GP GP GP GP
GP GP GP GP GP GP GP GP GP GP GP GP GP GP GP GP GP
GP GP GP GP GP GP GP GP GP GP GP GP GP GP GP GP GP
GP GP GP GP GP GP GP GP GP GP GP GP GP GP GP GP GP
GP GP GP GP GP GP GP GP GP GP GP GP GP GP GP GP GP

0 6
16 11