WB WB GP GP GP GP GP GP GP GP GP GP GP GP GP GP GP GP GP WB WB WB 
WB GP GP DM DM DM DM DM GP GP GP GP GP GP GP WB WB GP GP GP WB WB 
GP GP GP DM GP GP GP DM GP GP GP GP GP GP GP WB WB GP GP GP GP GP 
GP GP GP DM GP GP GP DM GP GP GP GP GP GP GP GP GP GP GP GP GP GP 
GP GP GP DM GP GP GP DM GP GP GP GP GP GP GP GP GP GP GP GP DM DM 
GP GP GP DM GP GP GP DM GP GP GP DM DM DM DM DM GP GP GP DM DM GP 
DM DM DM DM GP GP GP DM GP GP GP DM GP GP GP DM GP GP GP DM GP GP 
GP GP GP GP GP GP GP DM GP GP GP DM GP GP GP DM GP GP GP DM GP GP 
GP GP GP GP GP GP GP DM GP GP GP DM GP GP GP DM DM DM GP DM DM GP 
GP GP GP GP GP GP GP DM GP GP GP DM GP GP GP GP GP DM GP GP DM GP 
GP GP GP GP GP GP GP DM GP GP GP DM GP GP GP GP GP DM GP GP DM GP 
GP GP GP GP GP GP GP DM DM DM DM DM GP GP GP GP GP DM GP GP DM GP 
GP GP GP GP GP GP GP GP GP GP GP GP GP WB WB WB GP DM DM DM DM GP 
WB WB WB WB GP GP GP GP GP GP GP GP GP WB WB GP GP GP GP GP GP GP 
WB WB WB WB GP GP GP GP GP GP GP GP GP GP GP GP GP GP GP GP GP GP 
WB WB WB WB GP GP GP GP GP GP GP WB WB GP GP GP GP GP GP GP GP GP 
WB WB WB WB WB GP GP GP GP GP WB WB WB WB GP GP GP GP GP GP GP GP 
100 100
200 200